5 6
######
#S#.F#
#.#.##
#...##
######